MEN_IMPORT_GMF	GMF file
MEN_GMF	GMF file
MEN_CIRCLE	円
GEOM_REVERSE	反転
MEN_3DSKETCH	３D スケッチ
MEN_CONE	円錐
GEOM_RECTANGLE	四角形の作成
MEN_PIPETSHAPE	T型パイプ
MEN_EXTRUSION	面の押出し
MEN_REVOLUTION	回転体
GEOM_REVOLURION_TITLE	回転体の作成
MEN_PIPE_PATH	経路の復元
GEOM_PIPE_PATH_TITLE	経路の復元
GEOM_PIPE_BASE1_OBJECT	始点となるベース　面/ワイヤ/エッジ
GEOM_PIPE_BASE2_OBJECT	終点となるベース　面/ワイヤ/エッジ
GEOM_SQUARE	四角
MEN_EXPLODE	分解
MEN_COMPOUND	コンパウンド
MEN_TRANSLATION	移動
GEOM_POINT	基準点
GEOM_AXE_I	基軸
GEOM_PLAN	基準面
GEOM_BLACK_EXPLODE_TITLE	サブブロックの選択
MEN_ARCHIMEDE	アルキメデス法
GEOM_ARCHIMEDE_TITLE	アルキメデス法
GEOM_FILLET_1D_TITLE	1Dフィレットの作成
GEOM_FILLET_2D_TITLE	2Dフィレットの作成
GEOM_FILLET_TITLE	フィレットの作成
MEN_EXTRUDED_BOSS	押出し
MEN_EXTRUDED_CUT	押込み
Y	Y
FREE_BOUND	自由境界
GEOM_FREE_BOUNDARIES	自由境界
MEN_CLOSE_CONTOUR	輪郭を閉じる
GEOM_CLOSECONTOUR_TITLE	輪郭を閉じる
SMESH_USE_PREESTIMATED_LEMGTH	予測長さを使う
MEN_BUILD_COMPOUND	コンパウンドの作成
PROCESSINGIDENTICALGROUPS	同じグループの処理
SMESH_NO_CONCURENT	並列のサブメッシュが検出されません
SMESH_GROUP_GEOMETRY	ジオメトリ上のグループ
ELEM0D_TLT	0D要素 フィルター
BALL_TLT	粒子 フィルター
ASPECT_RATIO	アスペクト比
MULTI_BORDERS	複数の面に属する
TAPER	テーパー
MULTI2D_BORDERS	複数の面に属する 2D
BARE_BORDER_FACE	むき出しの境界線をもつフェース
COPLANAR_FACES	同一平面上の面
SMESH_PLUGINS_OTHER	SHESHplagins
MEN_CONNECTION	複数の面に属する
MEN_CONNECTION_2D	複数の面に属する 2D
MEN_BARE_BORDER_FACE	むき出しの境界線をもつフェース
MEN_ASPECT	アスペクト比
MEN_ASPECT_3D	アスペクト比 3D
MEN_BARE_BORDER__VOLUME	むき出しの境界線をもつボリューム
ASPECTRATION_ELEMENTS	アスペクト比
MEN_REORIENT_2D	ベクトルによってフェースの向きを変える
MEN_REVOLUTION	回転
MEN_MAP	パターンマッピング
MEN_CONV_TO_QUAD	2次要素の追加
MEN_2D_FROM_3D	境界要素の作成
MEN_CUT_PLANES	平面切断
LBL_ROT_Y	Y軸周りの回転
LBL_ROT_Z	Z軸周りの回転
Cut Planes Definition	平面切断のプロパティ
LBL_LINES_CUT	平面で切断
MEN_CUT_SEGMENT	線分で切断
LBL_CUT_SEGMENT	線分で切断のプロパティ
MEN_PLOT_3D	プロット３D
MENDEFORMED_SHAPE_AND_SCALAR_MAP	変形とスカラーマップ
MEN_ELASE_ALL	すべてを非表示
MEN_CLIPPING	面で切断
MNU_ANTICLOCKWISE_VIEW	左回転
MNU_CLOCKWISE_VIEW	右回転
MEN_RESET_VIEW	リセット
CAPTION	ビューの読み込み
DLG_SCALING	スケールの変更
MNU_GRADUATED_AXES	軸に目盛り付け
CAPTION	軸に目盛り付け
MNU_MINIMIZE_VIEW	最小化する
MNU_CHANGINGROTATIONPOINT_VIEW	回転の基準点を変更
LBL_TOORIGIN	原点を設定
不明	Plugins
